+--------------------------------------------------------------------------------------------------------------+
|##############################################################################################################|
|##############################################################################################################|
|##############################################################################################################|
|##############################################################################################################|
|##############################################################################################################|
|##############################################################################################################|
|##############################################################################################################|
|##############################################################################################################|
|##############################################################################################################|
|##############################################################################################################|
|##############################################################################################################|
|##############################################################################################################|
|##############################################################################################################|
|##############################################################################################################|
|##############################################################################################################|
|##############################################################################################################|
|##############################################################################################################|
|##############################################################################################################|
|##############################################################################################################|
|##############################################################################################################|
|##############################################################################################################|
|##############################################################################################################|
|##############################################################################################################|
|##############################################################################################################|
|##############################################################################################################|
|##############################################################################################################|
|##############################################################################################################|
|##############################################################################################################|
|##############################################################################################################|
|##############################################################################################################|
|##############################################################################################################|
|##############################################################################################################|
|##############################################################################################################|
|##############################################################################################################|
|##############################################################################################################|
|##############################################################################################################|
|##############################################################################################################|
|##############################################################################################################|
|##############################################################################################################|
|##############################################################################################################|
|##############################################################################################################|
|##############################################################################################################|
|##############################################################################################################|
|##############################################################################################################|
|##############################################################################################################|
|##############################################################################################################|
|##############################################################################################################|
|##############################################################################################################|
|##############################################################################################################|
|##############################################################################################################|
|##############################################################################################################|
|##############################################################################################################|
|##############################################################################################################|
|##############################################################################################################|
|##############################################################################################################|
|##############################################################################################################|
|##############################################################################################################|
|##############################################################################################################|
|##############################################################################################################|
|##############################################################################################################|
|##############################################################################################################|
|##############################################################################################################|
|##############################################################################################################|
|##############################################################################################################|
|##############################################################################################################|
|##############################################################################################################|
|##############################################################################################################|
|##############################################################################################################|
|##############################################################################################################|
|##############################################################################################################|
|##############################################################################################################|
|##############################################################################################################|
|##############################################################################################################|
|##############################################################################################################|
|##############################################################################################################|
|##############################################################################################################|
|##############################################################################################################|
|##############################################################################################################|
|##############################################################################################################|
|##############################################################################################################|
|##############################################################################################################|
|##############################################################################################################|
|##############################################################################################################|
|##############################################################################################################|
|##############################################################################################################|
|##############################################################################################################|
|##############################################################################################################|
|##############################################################################################################|
|##############################################################################################################|
|##############################################################################################################|
|##############################################################################################################|
|##############################################################################################################|
|##############################################################################################################|
|##############################################################################################################|
|##############################################################################################################|
|##############################################################################################################|
|##############################################################################################################|
|##############################################################################################################|
|##############################################################################################################|
+--------------------------------------------------------------------------------------------------------------+

+----------------------------------------------------HERO------------------------------------------------------+
|                                                                                                              |
|                                                                                                              |
|                                                                                                              |
|                                                                                                              |
|                                                                                                              |
+--------------------------------------------------------------------------------------------------------------+

+-------------------------------------------------STAGE MENU-------------------------------------------------- +
|                                                                                                              |
|                                                                                                              |
|                                                                                                              |
|                                                                                                              |
|                                                                                                              |
|                                                                                                              |
+--------------------------------------------------------------------------------------------------------------+